!!!!!!!!!!!!!!!!!!!!!!!!!!!&!!!!!!!!!!!!!!!!!!!!!!!!!!!
***************************.***************************
****...................****.***############**######****
****.*****************.****.***#**********#**#****#****
****.*****************.****.***#**********#**#****#****
****...........*******.****.***#**********#**#****#****
**************.*******.****.***#**********####*####****
*...........**.*******.****.***#***************#*******
*.*********.**.*******.****.***#***************#**###**
*.***...***.**.*******.****.***#****##########*#**#*#**
*.***.*.***.**.*******.****.***#****#********#*#**#*#**
*.***.*.***.**.*****...****.***#****#********#*#**#*#**
*.***.*.***.**.*****.******.***#****#**.....*#*#**#*#**
*.***.*.***.**.*****.******.***#****#**......#*#**#*#**
*.***.*.***.**.*****.******.***#****#**.==..***#**#*#**
*.***.*.***.**.*****...****.***#****#**.....***#**#*#**
*.***.*.***.**.*******.****.***#****#**.....***#**#*#**
*.***.*.***.**.*******.****.***#****#**********####*#**
*.***.*.***.**....****.****.***#****#***************#**
*.***.*.***.*****.****.****.***#****#################**
*.***.*.***.*****.****.****.***#****#******************
*.***.*.***.*****.****.****.***#****#******************
*.***.*.....*****.**.....**.***#****#******************
*.***.***********.**.....**.***#****#******************
*.***.***********.**.....**.***#****#******************
*.***.***********.**.==..**.***#****#******************
*.***.***********.**.....**.***#****X******************
*.***.***********.*********.........................***
*.***.............*********.***********************.***
*.*************************.***********************.***
*....**********************.***********************.***
****.******.*******.*******.***********************.***
****........................**********************...**
**************************************************.@.**
**************************************************...**
